****************
*     *        *
* *** * **** * *
* *   *    * * *
* * ****** * * *
* *      * *   *
* **** * * *****
*    * * *     *
**** * * ***** *
*    * *     * *
* ****** *** * *
*      * *   * *
****** * * *** *
*      *   *   *
* *********** **
*              *
****************